Exploration
██████████████████████████████████████████████
██████████████████████████ ███████████████████
████████████████     █████ ███████████████████
████████████████  s                ███████████
████████████████     █████████ ██ ████████████
███████████████████████ ██████ ██ ██ █████████
███████████████████████ █████████    █████████
███████████████████████ █████████ █▒██████████
██████████████████                █▒██████████
████████████     ▒ ███████ ████████   ████████
██████████████████ ███████X████████ █ ▒███████
██████████████████                    ████████
███████████████████████ ████████████ █████████
██████████████████████   ███████████ ████    █
██████████████████████ X ███████████ ████▒████
██████████████████████   ███████████     X  ██
██████████████████████████████   █▒█ ██ █ ████
██████████████████████████████    ▒█ ██ █ ████
██████████████████████████████   █ █ ██ █ ████
██████████████████████████████████  X    x  ██
████████████████████████████████████ ████ ████
████████████████████████████████████      ████
████████████████████████████████████ █ ███████
██████████████████████████████████████ ███████
██████████████████████████████████████ ███████
██████████████████████████████████████ ███████
██████████████████████████████████████ ███████
██████████████████████████████████████     ███
██████████████████████████████████████ ███████
███████████████████████████████████    ███████
██████████████████████████████ ███████ ███████
██████████████████████████████ ███████ ███████
█████████████████████████   ██ ██   ██ ███████
█████████████████████████        x      ██████
█████████████████████████  ▒██ ██   ██████████
██████████████████████████████ ███████████████
█████████████████████████▒  ██ ██   ██████████
█████████████████████████          x █████████
█████████████████████████   ██ ██ x   ████████
██████████████████████████████ ███     ███████
██████████████████████████████ ████   x ██████
████████████████████████████████████ x  ██████
█████████████████████████████████████   ██████
██████████████████████████████████████ ███████
█ X X X X ████████████████████████████ ███████
█X X   X X█████   ████████████████████ ███████
█ x     x █████▒██████████████████████ ███████
█ x     x        ████████████████████   ██████
█X X   X X█████  ███████████████████    ██████
█ X X X X █████ ███████████████████xy   ██████
█████ █████████E██████████████F███   y ███████
█████ █████████E x   ██   ████ ██    x████████
█████ █████████yyy   B        f      █████████
█████  ████████      █████ ██████   ██████████
█████  █████████████████   ███████████████████
█████ ▒ ███████████████EEEEE████EEE███████████
████  █ ███████████████E x        E███████████
█████   ███████████████EEEEE█████ E███████████
█████ ██████████████████   ██████   ██████████
█████ ███████████████████ ███████ ████████████
█████ ███████████████████ ███▒▒   ▒███████████
████  ██████████████████EEE██████ E███████████
████  █████████████████EEb        E███████████
█████ ████  ████████████EEE█████EEE███████████
█████ ████  █████████████E████████████████████
█████ ████  ██████████████████████████████████
█████ ████  ██████████████████████████████████
████   xx         ████████████████████████████
████    x   █████ ████████████████████████████
█████████████████    █████████████████████████
████████████████████ █████████████████████████
████████████████████ █████████████████████████
████████████████████ █████████████████████████
████████████████████ █▒█████████████ e ███████
████████████████████   █████████████   ███████
██████████████████████  █████████████ ████████
███████████████████████ ████████████▒  ███████
███████████████████████ ██XXX████████ ████████
███████████████████████ ██XXX█XX█████ ████████
███████████████████████   XXX█XX█X███ ████████
█████████████████████████             ████████
██████████████████████████xxx█xx█x████████████
██████████████████████████xxx█xx██████████████
██████████████████████████xxx█████████████████
██████████████████████████████████████████████
Solution :

Strange Attraction
████████████████████████████████████████
█m x████   ████  ▒████   ████   █████▒ █
█  x     mx        @ ▒          ▒  @  ▒█
█  x████   ████   ████   ████   ████▒ ██
██ ██████x██████ ██████ ██████ ██████ ██
██ ██████y██████ ██████ ██████ ██████▒██
██ ██████x██████ ██████ ██████ ██████ ██
██x██████y██████x██████ ██████ █████████
█   ████ x ████   ████   ████   █████ ██
█ m          █X m  x       █M   M█    ██
█xxx████   ████   ████   ████   █████▒ █
██▒██████x██████X██████@██████ ██████ ██
██ ██████x██████▒██████@██████ ██████ ██
█████████x██████@██████ ██████x██████▒██
██e██████ ██████@██████▒██████ ██████▒██
█   ████   ████   ████   ████   ████   █
█    DF     ▒ █   y      M█            M
█   ████   ████   ████   ████   ████   █
██ ██████ ██████ ██████ ██████ ██████ ██
█████████ ██████ ██████ ██████▒██████ ██
██ ██████ ██████ ██████ ██████▒██████ ██
██ ██████ ██████ ██████ ██████ ██████ ██
█Mm ███Xb bx███   ████   ████   ████ x █
█ █m▒█▒xdmdX ██ s  █   M               █
█ M ███Xf fx███   ████   ████   ████   █
████████████████████████████████████████
Solution :

Offering
██████████████████████████████████████████████
███████████████████████████████YXYZXY█████████
███████████████████████████████X████ █████████
███████████████████████████████Y████X█████████
█████   ███████████████████████X████Y█████████
████   x  █████████████████████Y████X█████████
███        ████████████████████X████Y█████████
██         ████████████████████Y████X█████████
██         ████████████████████X████Y█████████
██        █████████████████████Z████X█████████
█ X      █████████████████████ZZZ███Y█████████
█       █████████████████████XXEXX██X█████████
█       █████████████████████XEMEX██Y█████████
█x       ████████████████████XX XX██X█████████
██       X█████████████████████ ████Y█████████
██       ██████████████████████ ████X█████████
██       █████████████     ████ ████Y█████ e █
██        ███████████  X         EEEXEEEEE   █
███       ██████████       ███   █████████   █
███        ████████       ████████████████████
███         █████         ████████████████████
██X                       ████████████████████
█     X                  █████████████████████
█               s      ███████████████████████
█     ██              ████████████████████████
█  X ████              ███████████████████████
██ X███████x            x█████████████████████
██████████████XX            X ████████████████
███████████████X██             ███████████████
████████████████████            ██████████████
█████████████████████           ██████████████
██████████████████████          ██████████████
███████████████████████        ███████████████
███████████████████████        ███████████████
████████████████████████ X   x████████████████
████████████████████████    ██████████████████
██████████████████████████████████████████████
Solution :
WEST WEST WEST WEST WEST WEST WEST WEST NORTH NORTH NORTH NORTH NORTH NORTH NORTH NORTH WEST NORTH NORTH NORTH NORTH NORTH NORTH NORTH NORTH NORTH WEST NORTH NORTH EAST SOUTH SOUTH SOUTH SOUTH SOUTH SOUTH SOUTH SOUTH SOUTH SOUTH SOUTH SOUTH SOUTH SOUTH SOUTH SOUTH WEST SOUTH EAST EAST EAST EAST EAST EAST EAST EAST EAST EAST EAST EAST EAST EAST EAST EAST SOUTH EAST NORTH NORTH NORTH NORTH WEST NORTH EAST EAST EAST EAST EAST EAST EAST EAST SOUTH EAST NORTH NORTH NORTH SOUTH SOUTH EAST EAST EAST EAST EAST EAST EAST EAST EAST EAST EAST EAST NORTH  (100)

Pushing Forward
██████████████████████████████████████████
██   ████████████Z██████Z█████████████ e █
█     ██████ZX█Y█X██████Z█████████████   █
█      X██Y█XYXZ█XY██Y█YY███████Y█████   █
█      X  YXZYXZYXY█YX█XY █MMMMMXMM████B██
█      X             X█ YX█        ███   █
██ x s  mmmmmmmmmmmmmmmmmmm        mmm b █
██     X██████          Z██        ███   █
███    X██████ZYXYX Y█YXZ██MMMXMMMM███████
█████  X██████ZY█YX███YX██████X███████████
██████████████ZZ█YX████X██████████████████
██████████████████████████████████████████
Solution :
WEST NORTH WEST WEST SOUTH EAST EAST EAST EAST EAST EAST EAST EAST EAST EAST EAST EAST EAST EAST EAST EAST EAST EAST EAST EAST EAST EAST EAST EAST EAST EAST EAST EAST EAST EAST EAST EAST EAST EAST EAST EAST NORTH EAST NORTH NORTH NORTH NORTH  (47)

Buttons
███████████████
████   █   ████
███ b       ███
███    x    Be█
███    X    ███
████ xXMXx ████
███    X    ███
█s     x    ███
███       b ███
████   █   ████
███████████████
Solution :
EAST EAST EAST EAST NORTH NORTH NORTH NORTH NORTH EAST EAST EAST SOUTH WEST WEST WEST SOUTH WEST NORTH EAST EAST EAST EAST EAST SOUTH SOUTH SOUTH SOUTH SOUTH WEST WEST WEST NORTH EAST EAST EAST NORTH EAST SOUTH NORTH NORTH NORTH NORTH EAST EAST EAST  (46)

Maze
█████████████████
█YYYYXYYZeZXZYXX█
█X   Z  B Zb   X█
█Y X Z XXYYY X Y█
█Y X X Y   X Z Y█
█X X   Y s Y Z X█
█X   Z X   Y Z Y█
█Y X Z XX XY   X█
█Y X X       ZYX█
█Y   ZXZ ZZY X Y█
█X X    x      X█
█X XZZXZ ZZZ Z X█
█X             Y█
█YXYYXXYXYXYYXYX█
█████████████████
Solution :
SOUTH SOUTH SOUTH EAST EAST EAST SOUTH SOUTH SOUTH SOUTH WEST WEST WEST WEST NORTH NORTH NORTH SOUTH WEST WEST WEST WEST NORTH NORTH NORTH NORTH NORTH EAST EAST SOUTH SOUTH SOUTH EAST EAST EAST EAST EAST WEST WEST WEST SOUTH SOUTH EAST EAST EAST EAST NORTH NORTH NORTH NORTH NORTH NORTH NORTH SOUTH SOUTH SOUTH SOUTH EAST EAST NORTH NORTH NORTH NORTH NORTH WEST WEST SOUTH SOUTH SOUTH SOUTH SOUTH SOUTH WEST WEST WEST WEST WEST WEST NORTH NORTH NORTH NORTH NORTH NORTH EAST EAST EAST NORTH  (88)